######################################### 
|                                       | 
|                                       | 
|        |                              | 
|        |       |                      | 
|                |                      | 
|                |                      | 
|                          |            | 
|                          |            | 
|     |                                 | 
|     |                                 | 
|                       |               | 
|                       |               | 
|                       %%%%%%%%%%      | 
|                                |      | 
|           |                    |      | 
|           |       %%%%%               | 
|                                       |     
#########################################  
